R 2000   355


NO ./cub textures 256_256/north.xpm
SO ./cub textures 256_256/south.xpm
WE ./cub textures 256_256/west.xpm
EA ./cub textures 256_256/east.xpm
 S ./cub textures 256_256/pirate.xpm

F   124    ,    166,        146 
C 164   ,     166,        152




        111111111111111111111111111111111111
        100000000110000000000000000000000001
        101100001110000000000111111111111111111111111111
        1111000000000000222000000000000000000000000001111
        100100002222222220000200002002000W0000000000000001111 1
111111111011000022222222000002000020000000020000000111111    101
100000000011000200000020002220220000000111111111111           1
1111011110000000000000020000011111111111
111101111111000000000000200001
100000011010110100000000020111
1000010000000100000110000021001
10001010000011110011010100000011
110001011101010111110000000111
11110111 1110101101111010001
11111111 1111111 111111111111
101                1
 1                      1
1
1
1
             1