R 1920 1080
NO ./path_to_the_north_texture
SO ./path_to_the_south_texture
WE ./path_to_the_west_texture
EA ./path_to_the_east_texture
S ./path_to_the_sprite_texture

F   220 ,       100,        150
C 255   ,     30,        240




        1111111111111111111111111 1
        1000000000110000000000001 1
        1011000001110000002000001 1
        10010000000000001E00000001 1
111111111011000001110000000000001 1
100000000011000001110111111111111 1
111101111211110111000W0010001     1
11110111111111011101010010001     1
110000001111010111000000100011    1
1000200001 10002001110200010001     1
100000000010000110101001000111   1
110000011101010111110111100111   1
11110111 1110101 1011110100011    1
11111111 1111111 111111111111     1
101
 1