R 3200 1800

NO ./path_to_the_north_texture
SO ./path_to_the_south_texture
WE ./path_to_the_west_texture
EA ./path_to_the_east_texture
S ./path_to_the_sprite_texture

F   124    ,    166,        146 
C 164   ,     166,        152




        111111111111111111111111111111111111
        1000000000110000000000000000000000001
        101100000111000000000001111111111111
        11110002000000000000000000000000000111
        100100000000000000000000000000000001
11111111101100000000000000000000000000000001
100000000011E000000000000000000000000111111111111
111101111000000000000000000011111111111
111101111111000000000000000001
100000011010110100000000000111
1000010000000100000110000001001
10001010020011110011010100000011
110001011101010111110000000111
11110111 1110101101111010001
11111111 1111111 111111111111
101                1
 1                      1
1
1
1
             1