R 3200 1800

NO /home/kremen/Downloads/21/MAIN/Ecole-42/my_cub3d/cub textures 276_276/north.xpm
SO /home/kremen/Downloads/21/MAIN/Ecole-42/my_cub3d/cub textures 276_276/south.xpm
WE /home/kremen/Downloads/21/MAIN/Ecole-42/my_cub3d/cub textures 276_276/west.xpm
EA /home/kremen/Downloads/21/MAIN/Ecole-42/my_cub3d/cub textures 276_276/east.xpm
  S /home/kremen/Downloads/21/MAIN/Ecole-42/my_cub3d/cub textures 276_276/pirate.xpm

F   124    ,    166,        146 
C 164   ,     166,        152




        111111111111111111111111111111111111
        100000000110000000000000000000000001
        101100001110000000000111111111111111111111111111
        11110000000000000000000000000000000000000001111
        10010000000000000000000000000000000000001111  1
1111111110110000010000000000000000000000000111111    101
100000000011000E01000000000020000000111111111111      1
1111011110000000000000000000011111111111
111101111111000000000000000001
100000011010110100000000000111
1000010000000100000110000001001
10001010000011110011010100000011
110001011101010111110000000111
11110111 1110101101111010001
11111111 1111111 111111111111
101                1
 1                      1
1
1
1
             1