R 3200 1800 

NO /home/kremen/Downloads/21/MAIN/Ecole-42/my_cub3d/textures/banner.xpm
SO /home/kremen/Downloads/21/MAIN/Ecole-42/my_cub3d/textures/brick.xpm
WE /home/kremen/Downloads/21/MAIN/Ecole-42/my_cub3d/textures/eagle.xpm
EA /home/kremen/Downloads/21/MAIN/Ecole-42/my_cub3d/textures/grey.xpm
S /home/kremen/Downloads/21/MAIN/Ecole-42/my_cub3d/textures/barrel.xpm


F   124    ,    166,        146 
C 164   ,     166,        152




        111111111111111111111111111111111111
        100000000110000000000000000000000001
        10110000111000000000001111111111111
        111100020000000W0000000000000000000111
        10010000000000000000000000000000001
11111111101100000000000000000000000000000001
1000000000110000000000000000000000000111111111111
111101111000000000000000000011111111111
111101111111000000000000000001
100000011010110100000000000111
1000010000000100000110000001001
10001010020011110011010100000011
110001011101010111110000000111
11110111 1110101101111010001
11111111 1111111 111111111111
101                1
 1                      1
1
1
1
             1