R 1920 1080

NO ./path_to_the_north_texture
SO ./path_to_the_south_texture
WE ./path_to_the_west_texture
EA ./path_to_the_east_texture
S ./path_to_the_sprite_texture

F   220 ,       100,        150
C 255   ,     30,        240




        111111111111111111111111111111111111
        1000000000110000000000000000000000001
        101100000111000000000001111111111111
        11110002000000N00000111
        100100000000000000000001
111111111011000001110000000000001
100000000011000001110111111111111
11110111101111011100000010001
11110111111111111101010010001
100000011010110110000001000111
1000010000000100000110000001001
10001010020011110011010100000011
110001011101010111110000000111
11110111 1110101101111010001
11111111 1111111 111111111111
101
 1